
gaijimap
大部分取自 ebwin 自带数据

http://ebstudio.info/manual/EBMac/61unicodemap.php

CHUJITEN5.json: modified from CHUJITEN_FMV.map (EPWING「研究社新英和(第6版)・新和英中辞典」(初期のFMV付属品))
研究社　新英和中辞典


SHINNMEIKAI5.json
新明解第五版(注音调版) epwing



-----

Original

CHUJITEN_FMV	研究社新英和６版・和英４版（EPWING初期FMV付属）
CHUJITEN_EB1993	研究社新英和６版・和英４版(EB)
CHUJITEN"	研究社新英和６版・和英４版（EPWING後期）
COLLOC	研究社新編英和活用大辞典(EPWING,LogoVista)
CROWN	クラウン仏和・和仏、クラウン独和・和独(EPWING,EB)
DAIJIRIN	大辞林第２版(EPWING)
DAIJISEN	大辞泉(EBStudio+Toolkit)
EBSTUDIO	EBStudio標準Latin-1
EIDAI6	研究社新英和大辞典第６版(EPWING)
GENIUS_DAIEIWA	ジーニアス大英和辞典(EPWING)
GENIUS	ジーニアス第３版、ジーニアスシリーズ標準(EPWING)
GENIUS4	ジーニアス第４版DVD-ROM(EPWING)
GENIUS43	ジーニアス第４版和英第３版(Logovista)
GEJCJE	新グローバル英和辞典・ニューセンチュリー和英辞典(EPWING)
IBE01	岩波仏教辞典第１版(EBXA)
IWKOKUG7	岩波国語辞典第７版(Logovista)
JBCD	ブリタニカ国際大百科事典(EBStudio+Toolkit)
KANJIGEN_EB	漢字源(EBXA)
KANJIGEN_EPW	漢字源(EPWING)
KENE7J5	研究社新英和７版・和英５版（Logovista）
KOJIEN	広辞苑第４版(EPWING・EBXA)、第５版(EPWING・EBXA)、第６版(EPWING)
KQCOLEXP	研究社日本語口語表現辞典(LogoVista)
MANYO	万葉集(EBStudio)
MEIKYOU	明鏡国語辞典(LogoVista)
MEIKYOU2	明鏡国語辞典第２版(LogoVista)
MEIKYO2R	明鏡国語辞典第2版 総ふりがな版(LogoVista)
MYPAEDIA	MyPedia(EBStudio+Toolkit)
NEWANC	学研ニューアンカー(EBXA)
NKGORIN2	新漢語林 第二版(Logovista)
READERS1	研究社リーダーズ第1版(EPWING)
READERS2	研究社リーダーズ第2版(EPWING,LogoVista)、研究社新和英大辞典第５版(EPWING)、研究社新英和大辞典第６版(EPWING)
READERS3	リーダーズ第３版(Logovista)
RIKAGAKU	岩波理化学事典(EPWING)
SRD	ランダムハウス英語辞典(EBStudio+Toolkit)
SINMEI7	新明解第7版(LogoVista)
WADAI5	研究社新和英大辞典第５版(EPWING)
YHOUGO4	有斐閣 法律用語辞典 第4版(Logovista)
ZHONG_RI	小学館日中中日辞典第１版（EBXA-C）

------

